Point6-4
Guard Gallivant Solution
An Interactive Fiction by David Yates
Release 1 / Serial number 241223 / Inform 7 v10.1.2 / D

Point6-4

>patrol
Point5-4

Point4-4

Point3-4

Point2-4

Point1-4
Turning right...
You have visited 6 rooms so far.

Point1-5

Point1-6

Point1-7

Point1-8
Turning right...
You have visited 10 rooms so far.

Point2-8

Point3-8

Point4-8

Point5-8

Point6-8
Turning right...
You have visited 15 rooms so far.

Point6-7

Point6-6

Point6-5

Point6-4

Point6-3

Point6-2
Turning right...
You have visited 20 rooms so far.

Point5-2

Point4-2
Turning right...
You have visited 22 rooms so far.

Point4-3

Point4-4

Point4-5

Point4-6
Turning right...
You have visited 25 rooms so far.

Point5-6

Point6-6

Point7-6

Point8-6
Turning right...
You have visited 28 rooms so far.

Point8-5

Point8-4

Point8-3

Point8-2

Point8-1
Turning right...
You have visited 33 rooms so far.

Point7-1
Turning right...
You have visited 34 rooms so far.

Point7-2

Point7-3

Point7-4

Point7-5

Point7-6

Point7-7
Turning right...
You have visited 39 rooms so far.

Point8-7

Point9-7
You visited these rooms: Point1-5, Point1-6, Point1-7, Point1-8, Point1-4, Point2-4, Point2-8, Point3-4, Point3-8, Point4-3, Point4-4, Point4-5, Point4-6, Point4-8, Point4-2, Point5-2, Point5-4, Point5-6, Point5-8, Point6-2, Point6-3, Point6-4, Point6-5, Point6-6, Point6-7, Point6-8, Point7-2, Point7-3, Point7-4, Point7-5, Point7-6, Point7-7, Point7-1, Point8-1, Point8-2, Point8-3, Point8-4, Point8-5, Point8-6, Point8-7 and Point9-7
You have visited 41 rooms in total.

    *** The End ***

Would you like to RESTART, RESTORE a saved game, QUIT or UNDO the last command?

>s
You've been here before.

Point6-4

* * *

>restart
Point6-4
Guard Gallivant Solution
An Interactive Fiction by David Yates
Release 1 / Serial number 241220 / Inform 7 v10.1.2 / D

Point6-4

>pathfind
Enter path locations

>Point1-5 Point1-6 Point1-7 Point1-8 Point1-4 Point2-4 Point2-8 Point3-4 Point3-8 Point4-3 Point4-4 Point4-5 Point4-6 Point4-8 Point4-2 Point5-2 Point5-4 Point5-6 Point5-8 Point6-2 Point6-3 Point6-4 Point6-5 Point6-6 Point6-7 Point6-8 Point7-2 Point7-3 Point7-4 Point7-5 Point7-6 Point7-7 Point7-1 Point8-1 Point8-2 Point8-3 Point8-4 Point8-5 Point8-6 Point8-7 Point9-7
The path is: Point1-5, Point1-6, Point1-7, Point1-8, Point1-4, Point2-4, Point2-8, Point3-4, Point3-8, Point4-3, Point4-4, Point4-5, Point4-6, Point4-8, Point4-2, Point5-2, Point5-4, Point5-6, Point5-8 and Point6-2

>loop
Loops can be created in 0 ways.

    *** The End ***

Would you like to RESTART, RESTORE a saved game, QUIT or UNDO the last command?

* * *

>Point1-5 Point1-6 Point1-7 Point1-8 Point1-4 Point2-4 Point2-8 Point3-4 Point3-8 Point4-3 Point4-4 Point4-5 Point4-6 Point4-8 Point4-2 Point5-2 Point5-4 Point5-6 Point5-8 Point6-2 Point6-3 Point6-4 Point6-5 Point6-6 Point6-7 Point6-8 Point7-2 Point7-3 Point7-4 Point7-5 Point7-6 Point7-7 Point7-1 Point8-1 Point8-2 Point8-3 Point8-4 Point8-5 Point8-6 Point8-7 Point9-7
The path is: Point1-5, Point1-6, Point1-7, Point1-8, Point1-4, Point2-4, Point2-8, Point3-4, Point3-8, Point4-3, Point4-4, Point4-5, Point4-6, Point4-8, Point4-2, Point5-2, Point5-4, Point5-6, Point5-8 and Point6-2

>pathfind
Enter path locations

>Point6-3 Point6-4 Point6-5 Point6-6 Point6-7 Point6-8 Point7-2 Point7-3 Point7-4 Point7-5 Point7-6 Point7-7 Point7-1 Point8-1 Point8-2 Point8-3 Point8-4 Point8-5 Point8-6 Point8-7 Point9-7
The path is: Point1-5, Point1-6, Point1-7, Point1-8, Point1-4, Point2-4, Point2-8, Point3-4, Point3-8, Point4-3, Point4-4, Point4-5, Point4-6, Point4-8, Point4-2, Point5-2, Point5-4, Point5-6, Point5-8, Point6-2, Point6-3, Point6-4, Point6-5, Point6-6, Point6-7, Point6-8, Point7-2, Point7-3, Point7-4, Point7-5, Point7-6, Point7-7, Point7-1, Point8-1, Point8-2, Point8-3, Point8-4, Point8-5, Point8-6 and Point8-7

>pathfind
Enter path locations

>Point9-7
The path is: Point1-5, Point1-6, Point1-7, Point1-8, Point1-4, Point2-4, Point2-8, Point3-4, Point3-8, Point4-3, Point4-4, Point4-5, Point4-6, Point4-8, Point4-2, Point5-2, Point5-4, Point5-6, Point5-8, Point6-2, Point6-3, Point6-4, Point6-5, Point6-6, Point6-7, Point6-8, Point7-2, Point7-3, Point7-4, Point7-5, Point7-6, Point7-7, Point7-1, Point8-1, Point8-2, Point8-3, Point8-4, Point8-5, Point8-6, Point8-7 and Point9-7

* * *

Point6-4
Guard Gallivant Solution
An Interactive Fiction by David Yates
Release 1 / Serial number 241223 / Inform 7 v10.1.2 / D

Point6-4

>forward
That's not a verb I recognise.

* * *

Point6-4
Guard Gallivant Solution
An Interactive Fiction by David Yates
Release 1 / Serial number 241223 / Inform 7 v10.1.2 / D

Point6-4

>n
0
Point5-4

>w
0
Point5-3

>s
0
Point6-3

>e
1
Point6-4

>n
1
Point5-4

>w
1
Point5-3

>s
1
Point6-3

>e
2Stuck in a loop, resetting.

Point6-4
Point6-4

>n
0
Point5-4

>s
1
Point6-4

* * *

>n
0
Point5-4

>e
0
Point5-5

>s
0
Point6-5

>w
1
Point6-4

>n
1
Point5-4

>e
1
Point5-5

>s
1
Point6-5

>w
2You've been here before.

Point6-4

* * *

>s
1
Point6-4

>n
1
Point5-4

>s
1
Point6-4

>n
2You've been here before.

Point5-4

>s
2You've been here before.

Point6-4

* * *

>s
1
Point6-4

>patrol
Variable unavailable for this action, activity or rulebook: internal ID number 20007/0

*** Run-time problem P10: Since nothing is not allowed the property "visit count", it is against the rules to try to use it.

* * *

Point6-4
Guard Gallivant Solution
An Interactive Fiction by David Yates
Release 1 / Serial number 241223 / Inform 7 v10.1.2 / D

Point6-4

>loop
I didn't understand that sentence.

* * *

Point6-4
Guard Gallivant Solution
An Interactive Fiction by David Yates
Release 1 / Serial number 241223 / Inform 7 v10.1.2 / D

Point6-4

>pathfind
Enter path locations

>Point6-4 Point5-4
The path you specified is: Point5-4 and Point6-4

>pathfind
Enter path locations

>Point6-4, Point5-6 and Point7-3
The path you specified is: Point5-4, Point6-4 and Point7-3

* * *

>pathfind
Enter path locations

>Point5-4, Point4-4, Point3-4, Point2-4, Point1-4, Point1-5, Point1-6, Point1-7, Point1-8, Point2-8, Point3-8, Point4-8, Point5-8, Point6-8, Point6-7, Point6-6, Point6-5, Point6-4, Point6-3, Point6-2, Point5-2, Point4-2, Point4-3, Point4-4, Point4-5, Point4-6, Point5-6, Point6-6, Point7-6, Point8-6, Point8-5, Point8-4, Point8-3, Point8-2, Point8-1, Point7-1, Point7-2, Point7-3, Point7-4, Point7-5, Point7-6, Point7-7, Point8-7 and Point9-7.
The path you specified is:

* * *

>pathfind
Enter path locations

>Point5-4, Point4-4, Point3-4, Point2-4, Point1-4, Point1-5, Point1-6, Point1-7, Point1-8, Point2-8, Point3-8, Point4-8, Point5-8, Point6-8, Point6-7, Point6-6, Point6-5, Point6-4, Point6-3, Point6-2, Point5-2, Point4-2, Point4-3, Point4-4, Point4-5, Point4-6, Point5-6, Point6-6, Point7-6, Point8-6, Point8-5, Point8-4, Point8-3, Point8-2, Point8-1, Point7-1, Point7-2, Point7-3, Point7-4, Point7-5, Point7-6, Point7-7, Point8-7 and Point9-7
The path you specified is:

>pathfind
Enter path locations

>Point5-4, Point4-4, Point3-4, Point2-4, Point1-4, Point1-5, Point1-6, Point1-7, Point1-8, Point2-8, Point3-8, Point4-8
The path you specified is:

>pathfind
Enter path locations

>Point5-4, Point4-4, Point3-4, Point2-4, Point1-4,
The path you specified is:

>pathfind
Enter path locations

>Point5-4, Point4-4
The path you specified is: Point4-4

>pathfind
Enter path locations

>Point5-4, Point4-4
The path you specified is: Point4-4 and Point4-4

>pathfind
Enter path locations

>Point5-4
The path you specified is: Point4-4, Point4-4 and Point5-4

>pathfind
Enter path locations

>Point5-4,
The path you specified is: Point4-4, Point4-4 and Point5-4

>pathfind
Enter path locations

>Point5-4
The path you specified is: Point4-4, Point4-4, Point5-4 and Point5-4

* * *

>pathfind
Enter path locations

>Point5-4 Point4-4 Point3-4 Point2-4 Point1-4 Point1-5 Point1-6 Point1-7 Point1-8 Point2-8 Point3-8 Point4-8 Point5-8 Point6-8 Point6-7 Point6-6 Point6-5 Point6-4 Point6-3 Point6-2 Point5-2 Point4-2 Point4-3 Point4-4 Point4-5 Point4-6 Point5-6 Point6-6 Point7-6 Point8-6 Point8-5 Point8-4 Point8-3 Point8-2 Point8-1 Point7-1 Point7-2 Point7-3 Point7-4 Point7-5 Point7-6 Point7-7 Point8-7 Point9-7
The path you specified is: Point1-5, Point1-6, Point1-7, Point1-8, Point1-4, Point2-4, Point2-8, Point3-4, Point3-8, Point4-4, Point4-8, Point5-4, Point5-8, Point6-2, Point6-3, Point6-4, Point6-5, Point6-6, Point6-7 and Point6-8

>pathfind
Enter path locations

>Point5-4 Point4-4 Point3-4 Point2-4 Point1-4 Point1-5 Point1-6 Point1-7 Point1-8 Point2-8 Point3-8 Point4-8 Point5-8 Point6-8 Point6-7 Point6-6 Point6-5 Point6-4 Point6-3 Point6-2 Point5-2 Point4-2 Point4-3 Point4-5 Point4-6 Point5-6 Point7-6 Point8-6 Point8-5 Point8-4 Point8-3 Point8-2 Point8-1 Point7-1 Point7-2 Point7-3 Point7-4 Point7-5 Point7-7 Point8-7 Point9-7
The path is: Point1-5, Point1-6, Point1-7, Point1-8, Point1-4, Point2-4, Point2-8, Point3-4, Point3-8, Point4-4, Point4-8, Point5-4, Point5-8, Point6-2, Point6-3, Point6-4, Point6-5, Point6-6, Point6-7 and Point6-8

I beg your pardon?

* * *

>Point9-7
The path is: Point1-5, Point1-6, Point1-7, Point1-8, Point1-4, Point2-4, Point2-8, Point3-4, Point3-8, Point4-3, Point4-4, Point4-5, Point4-6, Point4-8, Point4-2, Point5-2, Point5-4, Point5-6, Point5-8, Point6-2, Point6-3, Point6-4, Point6-5, Point6-6, Point6-7, Point6-8, Point7-2, Point7-3, Point7-4, Point7-5, Point7-6, Point7-7, Point7-1, Point8-1, Point8-2, Point8-3, Point8-4, Point8-5, Point8-6, Point8-7 and Point9-7

>loop
Point1-5
Point5-4

Point4-4

Point3-4

Point2-4

Point1-4
Turning right...
You have visited 6 rooms so far.

Turning right...
You have visited 6 rooms so far.

Point2-4

Point3-4

Point4-4

Point5-4

Point6-4

Point7-4

Point8-4

Point9-4
You have visited 9 rooms in total.

Endgame
Point1-6Point1-7Point1-8Point1-4Point2-4Point2-8Point3-4Point3-8Point4-3Point4-4Point4-5Point4-6Point4-8Point4-2Point5-2Point5-4Point5-6Point5-8Point6-2Point6-3Point6-4Point6-5Point6-6Point6-7Point6-8Point7-2Point7-3Point7-4Point7-5Point7-6Point7-7Point7-1Point8-1Point8-2Point8-3Point8-4Point8-5Point8-6Point8-7Point9-7Point9-4EndgameLoops can be created in 0 ways.

    *** The End ***

Would you like to RESTART, RESTORE a saved game, QUIT or UNDO the last command?

* * *

>Point9-7
The path is: Point1-5, Point1-6, Point1-7, Point1-8, Point1-4, Point2-4, Point2-8, Point3-4, Point3-8, Point4-3, Point4-4, Point4-5, Point4-6, Point4-8, Point4-2, Point5-2, Point5-4, Point5-6, Point5-8, Point6-2, Point6-3, Point6-4, Point6-5, Point6-6, Point6-7, Point6-8, Point7-2, Point7-3, Point7-4, Point7-5, Point7-6, Point7-7, Point7-1, Point8-1, Point8-2, Point8-3, Point8-4, Point8-5, Point8-6, Point8-7 and Point9-7

>loop
Point5-4

Point4-4

Point3-4

Point2-4

Point1-4
Turning right...
You have visited 6 rooms so far.

Turning right...
You have visited 6 rooms so far.

Point2-4

Point3-4

Point4-4

Point5-4

Point6-4

Point7-4

Point8-4

Point9-4
You have visited 9 rooms in total.

Endgame
Loops can be created in 0 ways.

    *** The End ***

Would you like to RESTART, RESTORE a saved game, QUIT or UNDO the last command?

* * *

>pathfind
Enter path locations

>say "[obstacle test] [number of entries in the path]"
The path is:

>patrol
Point5-4

Point4-4

Point3-4

Point2-4

Point1-4
Turning right...
You have visited 6 rooms so far.

Point1-5

Point1-6

Point1-7

Point1-8
Turning right...
You have visited 10 rooms so far.

Point2-8

Point3-8

Point4-8

Point5-8

Point6-8
Turning right...
You have visited 15 rooms so far.

Point6-7

Point6-6

Point6-5

Point6-4

Point6-3

Point6-2
Turning right...
You have visited 20 rooms so far.

Point5-2

Point4-2
Turning right...
You have visited 22 rooms so far.

Point4-3

Point4-4

Point4-5

Point4-6
Turning right...
You have visited 25 rooms so far.

Point5-6

Point6-6

Point7-6

Point8-6
Turning right...
You have visited 28 rooms so far.

Point8-5

Point8-4

Point8-3

Point8-2

Point8-1
Turning right...
You have visited 33 rooms so far.

Point7-1
Turning right...
You have visited 34 rooms so far.

Point7-2

Point7-3

Point7-4

Point7-5

Point7-6

Point7-7
Turning right...
You have visited 39 rooms so far.

Point8-7

Point9-7
You have visited 41 rooms in total.

Endgame

>restart
Are you sure you want to restart?

>pathfind
Please answer yes or no.

>Point1-5 Point1-6 Point1-7 Point1-8 Point1-4 Point2-4 Point2-8 Point3-4 Point3-8 Point4-3 Point4-4 Point4-5 Point4-6 Point4-8 Point4-2 Point5-2 Point5-4 Point5-6 Point5-8 Point6-2 Point6-3 Point6-4 Point6-5 Point6-6 Point6-7 Point6-8 Point7-2 Point7-3 Point7-4 Point7-5 Point7-6 Point7-7 Point7-1 Point8-1 Point8-2 Point8-3 Point8-4 Point8-5 Point8-6 Point8-7 Point9-7
Please answer yes or no.

>pathfind
Please answer yes or no.

>Point6-3 Point6-4 Point6-5 Point6-6 Point6-7 Point6-8 Point7-2 Point7-3 Point7-4 Point7-5 Point7-6 Point7-7 Point7-1 Point8-1 Point8-2 Point8-3 Point8-4 Point8-5 Point8-6 Point8-7 Point9-7
Please answer yes or no.

>pathfind
Please answer yes or no.

>Point9-7
Please answer yes or no.

>loop
Please answer yes or no.

* * *

>pathfind
Enter path locations

>Point1-5 Point1-6 Point1-7 Point1-8 Point1-4 Point2-4 Point2-8 Point3-4 Point3-8 Point4-3 Point4-4 Point4-5 Point4-6 Point4-8 Point4-2 Point5-2 Point5-4 Point5-6 Point5-8 Point6-2
The path is: Point1-5, Point1-6, Point1-7, Point1-8, Point1-4, Point2-4, Point2-8, Point3-4, Point3-8, Point4-3, Point4-4, Point4-5, Point4-6, Point4-8, Point4-2, Point5-2, Point5-4, Point5-6, Point5-8 and Point6-2

>Point6-3 Point6-4 Point6-5 Point6-6 Point6-7 Point6-8 Point7-2 Point7-3 Point7-4 Point7-5 Point7-6 Point7-7 Point7-1 Point8-1 Point8-2 Point8-3 Point8-4 Point8-5 Point8-6 Point8-7
That's not a verb I recognise.

>pathfind
Enter path locations

>Point6-3 Point6-4 Point6-5 Point6-6 Point6-7 Point6-8 Point7-2 Point7-3 Point7-4 Point7-5 Point7-6 Point7-7 Point7-1 Point8-1 Point8-2 Point8-3 Point8-4 Point8-5 Point8-6 Point8-7
The path is: Point1-5, Point1-6, Point1-7, Point1-8, Point1-4, Point2-4, Point2-8, Point3-4, Point3-8, Point4-3, Point4-4, Point4-5, Point4-6, Point4-8, Point4-2, Point5-2, Point5-4, Point5-6, Point5-8, Point6-2, Point6-3, Point6-4, Point6-5, Point6-6, Point6-7, Point6-8, Point7-2, Point7-3, Point7-4, Point7-5, Point7-6, Point7-7, Point7-1, Point8-1, Point8-2, Point8-3, Point8-4, Point8-5, Point8-6 and Point8-7

>pathfind
Enter path locations

* * *

>Point9-7
The path is: Point1-5, Point1-6, Point1-7, Point1-8, Point1-4, Point2-4, Point2-8, Point3-4, Point3-8, Point4-3, Point4-4, Point4-5, Point4-6, Point4-8, Point4-2, Point5-2, Point5-4, Point5-6, Point5-8, Point6-2, Point6-3, Point6-4, Point6-5, Point6-6, Point6-7, Point6-8, Point7-2, Point7-3, Point7-4, Point7-5, Point7-6, Point7-7, Point7-1, Point8-1, Point8-2, Point8-3, Point8-4, Point8-5, Point8-6, Point8-7 and Point9-7

I beg your pardon?

* * *

>Point1-5 Point1-6 Point1-7 Point1-8 Point1-4 Point2-4 Point2-8 Point3-4 Point3-8 Point4-3 Point4-4 Point4-5 Point4-6 Point4-8 Point4-2 Point5-2 Point5-4 Point5-6 Point5-8 Point6-2
The path is: Point1-5, Point1-6, Point1-7, Point1-8, Point1-4, Point2-4, Point2-8, Point3-4, Point3-8, Point4-3, Point4-4, Point4-5, Point4-6, Point4-8, Point4-2, Point5-2, Point5-4, Point5-6, Point5-8 and Point6-2

>pathfind
Enter path locations

* * *

>loop
Blocked Point1-6.

Point6-4

>loop
Blocked Point1-7.

Point6-4

>loop
Blocked Point1-8.

Point6-4

>loop
Blocked Point1-4.

Point6-4

* * *

Point6-4
Guard Gallivant Solution
An Interactive Fiction by David Yates
Release 1 / Serial number 241223 / Inform 7 v10.1.2 / D

Point6-4

>rules
Rules tracing now switched on. Type "rules off" to switch it off again, or "rules all" to include even rules which do not apply.

[Rule "parse command rule" applies.]

I beg your pardon?

* * *

Point6-4
Guard Gallivant Solution
An Interactive Fiction by David Yates
Release 1 / Serial number 241223 / Inform 7 v10.1.2 / D

Point6-4

>rulse
That's not a verb I recognise.

>rules
Rules tracing now switched on. Type "rules off" to switch it off again, or "rules all" to include even rules which do not apply.

[Rule "parse command rule" applies.]

* * *

Point6-4
Guard Gallivant Solution
An Interactive Fiction by David Yates
Release 1 / Serial number 241223 / Inform 7 v10.1.2 / D

Point6-4

>test findloop
(Testing.)

>[1] pathfind
Enter path locations >[2] point6-3
The path is: Point6-3
>[3] loop
Blocked Point6-3.

Point5-4
Point5-4

I beg your pardon?

* * *

>test findloop
(Testing.)

>[1] pathfind
Enter path locations >[2] point6-3
The path is: Point6-3
>[3] loop
Blocked Point6-3.

Point5-4
Point5-4

>go forward
You can't see any such thing.

>n
Point5-4 and Point4-4
Point4-4

>n
Point5-4, Point4-4 and Point3-4
Point3-4

>n
Point5-4, Point4-4, Point3-4 and Point2-4
Point2-4

>n
Point5-4, Point4-4, Point3-4, Point2-4 and Point1-4
Point1-4

>n
Turning right...
You have visited 6 rooms so far.

Point4-4, Point3-4, Point2-4, Point1-4 and Point1-5
Point1-5

>e
Point3-4, Point2-4, Point1-4, Point1-5 and Point1-6
Point1-6

>e
Point2-4, Point1-4, Point1-5, Point1-6 and Point1-7
Point1-7

>e
Point1-4, Point1-5, Point1-6, Point1-7 and Point1-8
Point1-8

>e
Turning right...
You have visited 10 rooms so far.

Point1-5, Point1-6, Point1-7, Point1-8 and Point2-8
Point2-8

>s
Point1-6, Point1-7, Point1-8, Point2-8 and Point3-8
Point3-8

>s
Point1-7, Point1-8, Point2-8, Point3-8 and Point4-8
Point4-8

>s
Point1-8, Point2-8, Point3-8, Point4-8 and Point5-8
Point5-8

>s
Point2-8, Point3-8, Point4-8, Point5-8 and Point6-8
Point6-8

>s
Turning right...
You have visited 15 rooms so far.

Point3-8, Point4-8, Point5-8, Point6-8 and Point6-7
Point6-7

>s
Point4-8, Point5-8, Point6-8, Point6-7 and Point7-7
Point7-7

>s
Point5-8, Point6-8, Point6-7, Point7-7 and Point8-7
Point8-7

>s
Point6-8, Point6-7, Point7-7, Point8-7 and Point9-7
Point9-7

>s
No loop here. Resetting...
Loops found so far: 0
Point6-4
Unblocked Point6-3.
All positions tested. Total loops: 0

    *** The End ***

Would you like to RESTART, RESTORE a saved game, QUIT or UNDO the last command?